1111111111111111111
1C1PPEEEECCC2348711
1111184901241284721
1111111111111111111