11111111111
10000000001
1 1PEC00001
11111111111
